10 10
### ######
#        #
# #### # #
#   #  # #
# # # ## #
#     #  #
##### ####
# # # ## #
#        #
####### ##
0 3
9 7

